..............................
.                            .
.                            .
.                            .
.            -------+-----   .
.            |...........|   .
.            +...........|   .
.            |...........|   .
.            |...........|   .
.            -------------   .
.                            .
.                            .
..............................